                                      
                                       
                    
                    
                    
                    
                    
                    
                                       
                                       
                                                W
                                     W          W     
                           W         W          W     
                     W                                                               
                                                                                           2277777777777
                                                                                         227777777777777
                                                                                       22777777777777777
        W           222222222222222222222222222222                                   2277777777777777777
    CCCCCCCCCCCCCCCCCCCCCCCCCC                                                       2222222222222222222
    CCCCC                                                                            2222222222222222222
                                                                                        2222222222222222
                                                                                        2222222222222222
22222222222222                                      RRRRRRR                          2222222222222222222
                                                                                     2222222222222222222
                                                                              Q    222222777777222222222
                                                                                  2222272222722227772222
              Q                                                                  28777727777222777777777
                        Q                                                       287777777222277777777777
                                              W                                2222222222222222222222222

                                                  
             Q  QQQQQRRQQQQQQ            22222222222222222                     2222222222222222222222222
                                                                              28772222772777777222277772
                                                                             287777777777277272727777722
                                                                            2872222222222777777772227227
                          2                                                28722777777777222222222227772
            Q           222                                               287277777777777222222222222772
                       2822                                              2877772222277777727227777777777
                      28222                                             28722222222222222777777722277772
33333333333333333333333333333333333333333333333333333333333333333333333333333333333333333333333333333333
44444444444444444444444444444444444444444444444444444444444444444444444444444444444444444444444444444444